#################################
######s#################     ####
###### ################## ## ####
####     ##############    #  ###
###        #########           e#
########## ########  ############
####     # ###  ###   ###########
######## #           #########  #
#################################