##########
#s########
# ### # ##
#  #    ##
##    #  #
#######e##
##########
