###############################
#s    #    #     #     #     ##
##### #### #  #  #  #  #  #####
##    #    #  #  #  #  #     ##
## #### ####  #  #  #  ####   #
##                          # ##
#######################  #### ##
##  #                    #    ##
##  #  ###################  ####
##     #        #  #     #    ##
##  #  #  #  #  #  #  ####### ##
##  #     #  #     #          ##
##  ######################  # ##
##  #     #     #           # ##
##  #  ####  #  #  ########## ##
##  #     #  #  #  #          ##
##  ####  #  ####  #  ####### ##
##  #  #  #        #  #     # ##
##  #  #  ##########  ####  # ##
##                 #        # e#
################################