##########
##s#######
## ## # ##
#  #    ##
##    #  #
#######e##
##########
