#################################
######s#################     ####
###### ################## ## ####
####     ##############    #  ###
###        #########           ##
########## ########  ############
####     # ###e ###   ###########
######## #           #########  #
#################################